x,x,x,I,x,x,x,x,x,x,
x,f,f,f,f,f,f,f,f,x,
x,f,f,f,i,f,f,f,f,x,
x,f,f,f,f,m,f,f,f,x,
x,f,f,f,f,f,f,f,f,x,
x,f,f,h,f,f,f,f,f,x,
x,f,f,f,f,f,f,f,f,x,
x,f,f,f,f,f,f,f,f,x,
x,f,f,f,f,f,f,f,f,x,
x,x,x,x,x,x,x,O,x,x,
