x,x,x,I,x,x,O,x,x,x,
x,f,f,f,f,f,f,f,f,x,
x,f,f,i,f,f,h,f,f,x,
x,f,f,f,f,f,f,f,f,x,
x,f,f,f,f,f,f,f,f,x,
x,f,f,f,f,f,f,f,f,x,
x,f,f,f,f,x,f,f,f,x,
x,f,f,f,f,f,f,f,f,x,
x,f,f,f,f,f,f,f,f,x,
x,x,x,x,x,x,x,x,x,x,
