x,x,x,x,I,x,x,x,x,x,
x,f,f,f,f,f,f,f,f,x,
O,f,f,f,i,f,f,f,f,x,
x,f,f,f,f,f,f,f,f,x,
x,f,f,f,f,f,f,f,f,x,
x,f,f,f,f,f,f,f,f,x,
x,f,f,f,f,f,f,f,f,x,
x,f,f,f,f,f,f,f,f,x,
x,f,m,f,f,f,f,f,f,x,
x,x,x,x,x,x,x,x,x,x,
