x,x,I,x,O,x,x,x,x,x,x,x,x,x,x,
x,f,f,f,i,f,f,f,f,f,f,f,f,f,x,
x,f,f,f,f,f,f,f,f,f,f,f,f,f,x,
x,f,f,f,f,f,f,f,f,f,f,f,f,f,x,
x,f,f,f,f,f,f,f,f,f,f,f,f,f,x,
x,f,f,f,f,f,f,f,f,f,f,f,f,f,x,
x,f,f,f,f,f,f,f,f,f,f,f,f,f,x,
x,f,f,f,f,f,f,f,f,f,f,f,f,f,x,
x,f,f,f,f,f,f,f,f,f,f,f,f,f,x,
x,f,f,f,f,f,f,f,f,f,f,f,f,f,x,
x,f,f,f,f,f,f,f,f,f,f,f,f,f,x,
x,x,x,x,x,x,x,x,x,x,x,x,x,x,x,
